TWTR = Twitter
BMPS-I = BMPS
LULU = Lululemon Athletica
LLOY-L = Lloyds
FB = Facebook
BT-A-L = BT
ZQK = Quiksilver
HOME-L = Home Retail
ZNGA = Zynga
VOD-L = Vodafone
T = AT&T
EVR-L = Evraz
AZN-L = AstraZeneca (UK)
HFD-L = Halfords
SBRY-L = Sainsbury
0017.HK = New World Dev
SMWH-L = WH Smith
DOM-L = Domino's Pizza Group
HRB = H&R Block
TSLA = Tesla Motors
RMG-L = Royal Mail
AMZN = Amazon
LLOY-L = Lloyds
BT-A-L = BT
HOME-L = Home Retail
VOD-L = Vodafone
EVR-L = Evraz
AZN-L = AstraZeneca (UK)
HFD-L = Halfords
SBRY-L = Sainsbury
SMWH-L = WH Smith
DOM-L = Domino's Pizza Group
RMG-L = Royal Mail
LMI-L = Lonmin
ULVR-L = Unilever
BARC-L = Barclays
EZJ-L = easyJet
DXNS-L = Dixons Retail
BDEV-L = Barratt Developments
WMH-L = William Hill
SMSN.IL = Samsung
TSCO-L = Tesco
IAG-L = IAG
SPD-L = Sports Direct International
RR-L = Rolls-Royce
MRW-L = Morrison S.
FRES-L = Fresnillo
TATE-L = Tate & Lyle
GSK-L = GSK
HLMA-L = Halma
KMR-L = Kenmare Resources
LGEN-L = LGEN
GPOR-L = Great Portland Estates
TW-L = Taylor Wimpey
NXT-L = Next
PFC-L = Petrofac
JMAT-L = J. Matthey
BOK-L = Booker
ELM-L = Elementis
WTB-L = Whitbread
POG-L = Petropavlovsk
BG-L = BG
RMV-L = Rightmove
EMG-L = Man Group
LAD-L = Ladbrokes
DGE-L = Diageo
AVV-L = Aveva Group
CNA-L = Centrica
BBY-L = Balfour Beatty
VED-L = Vedanta
RSA-L = RSA Insurance
ABF-L = British Foods
BP-L = B. Petroleum
SN-L = SNN
DEB-L = Debenhams
KAZ-L = Kazakhmys
BA-L = BAE Systems
ECM-L = Electrocomponents
RBS-L = RBS
BKG-L = Berkeley Group
BWY-L = Bellway
SHB-L = Shaftesbury
AAL-L = Anglo American
MKS-L = M. & Spencer
STJ-L = St James's Place
BATS-L = B.A. Tobacco
GRG-L = Greggs
CPG-L = Compass
BBA-L = BBA Aviation
AHT-L = Ashtead
PMO-L = Premier Oil
RRS-L = Randgold
WPP-L = WPP
- = Saga
PRU-L = Prudential
AV-L = Aviva
KGF-L = Kingfisher
ANTO-L = Antofagasta
GLEN-L = Glencore
IAP-L = ICAP
BLT-L = BHP Billiton
SVT-L = Severn Trent
AGK-L = Aggreko
TLPR-L = Tullett Prebon
ESNT-L = Filtrona
ICP-L = Intermediate Capital
SRP-L = Serco
SAB-L = Sabmiller
CLLN-L = Carillion
NG-L = National Grid
RIO-L = Rio Tinto
HWDN-L = Howden Joinery
ADN-L = Aberdeen Asset Management
EXPN-L = Experian
DRX-L = Drax
GFS-L = G4S
VSVS-L = Vesuvius
BRBY-L = Burberry
HMSO-L = Hammerson
PSN-L = Persimmon
SSE-L = SSE
STAN-L = Standard Chartered
AMEC-L = AMEC
ABG-L = African Barrick Gold
ITV-L = ITV
HL-L = Hargreaves L.
WOS-L = Wolseley
IMG-L = Imagination
BVS-L = Bovis Homes Group
LAND-L = Land Securities
HSBA-L = HSBC
RB-L = RB
CPI-L = Capita
ADM-L = Admiral
ARM-L = ARM
SNR-L = Senior
TALK-L = TalkTalk Telecom
GKN-L = GKN
LSE-L = LSE
MGGT-L = Meggitt
MTO-L = Mitie Group
TCG-L = Thomas Cook Group
RTO-L = Rentokil Initial
VCT-L = Victrex
III-L = 3i
TT-L = TUI Travel
PFG-L = Provident Financial
FLG-L = Resolution
CSR-L = CSR
REX-L = REXAM
DLN-L = Derwent London
MNDI-L = Mondi
JUP-L = Jupiter Fund Management
FGP-L = First
DMGT-L = DMGT
ISAT-L = Inmarsat
BVIC-L = Britvic
IMT-L = IMT
CHG-L = Chemring
SDR-L = Schroders
SHP-L = Shire
ENQ-L = EnQuest
POLY-L = Polymetal International
IHG-L = InterContinental Hotels
UBM-L = UBM
PIC-L = Pace
NEX-L = National Express Group
CNE-L = Cairn Energy
CAPC-L = Capital & Counties Properties
CSCG-L = Intu Properties
OPHR-L = Ophir Energy
RDSA-L = Royal Dutch S.
SL-L = Standard Life
CCL-L = Carnival
UU-L = United Utilities
BLND-L = British Land
TPK-L = Travis Perkins
MRO-L = Melrose
DLG-L = Direct Line
BTG-L = BTG
PNN-L = Pennon
DLAR-L = De La Rue
ROR-L = Rotork
FENR-L = Fenner
REL-L = Reed Elsevier
BEZ-L = Beazley
TLW-L = Tullow Oil
BAB-L = Babcock International
OML-L = Old Mutual
SMIN-L = Smiths
BNZL-L = Bunzl
ITRK-L = Intertek
BOY-L = Bodycote
BSY-L = British Sky
SPT-L = Spirent Communications
CWC-L = CWC
HAS-L = Hays
HIK-L = Hikma Pharmaceuticals
HGG-L = Henderson
ESSR-L = Essar Energy
ULE-L = Ultra Electronics
IMI-L = IMI
AFR-L = Afren
CBG-L = Close Brothers Group
FXPO-L = Ferrexpo
PSON-L = Pearson
CRDA-L = Croda International
BPTY-L = Bwin.party
SGE-L = Sage
WEIR-L = Weir
LRE-L = Lancashire
GNK-L = Greene King
SGC-L = Stagecoach
CEY-L = Centamin
IGG-L = IG  Holdings
TCY-L = Telecity
HSV-L = Homeserve
COB-L = Cobham
IPF-L = International Personal Finance
AML-L = Amlin
INCH-L = Inchcape
WG-L = Wood
MPI-L = Michael Page
SGRO-L = SEGRO
SXS-L = Spectris
HSX-L = Hiscox
HTG-L = Hunting
MGAM-L = Morgan Crucible
SMDS-L = Smith
ASHM-L = Ashmore
INF-L = Informa
SIA-L = Soco International
RCP-L = RIT Capital Partners
PHNX-L = Phoenix  Holdings
MYI-L = Murray International Trust
MCRO-L = Micro Focus
PFL-L = Premier Farnell
INVP-L = Investec
CGL-L = Catlin
ATST-L = Alliance Trust
SPX-L = Spirax-Sarco Engineering
TWTR = Twitter
GRPN = Groupon
LULU = Lululemon Athletica
FSLR = First Solar
FB = Facebook
IAG = IAMGOLD
ZQK = Quiksilver
TM = Toyota
ZNGA = Zynga
NGD = New Gold
T = AT&T
HLT = Hilton
DAL = Delta Air Lines
KING = King (Candy Crush)
QIHU = Qihoo 360
SNDK = SanDisk
MU = Micron
NFLX = Netflix
SPWR = SunPower
TWX = Time Warner
AMZN = Amazon
NEM = Newmont Mine.
YELP = Yelp
SLW = Silver Wheaton
BTG = B2Gold
C = Citi Group
ACAD = ACADIA Pharmaceuticals
WYNN = Wynn Resorts
AAPL = Apple
JPM = JPMorgan
MNKD = MannKind
ARNA = Arena Pharmaceuticals
ARIA = Ariad Pharmaceuticals
SBUX = Starbucks
GT = Goodyear
TWC = Time Warner Cable
GOOG = Google
GE = General Electric
HTZ = Hertz
FRAN = Francesca's Holdings
INTC = Intel
SYMC = Symantec
LNKD = LinkedIn
SWKS = Skyworks Solutions
OIBR = Oi
APC = Anadarko Petroleum
TSLA = Tesla Motors
CDE = Coeur d'Alene Mines
GILD = Gilead
AVNR = Avanir Pharmaceuticals
BA = Boeing
MRK = Merck
AUQ = AuRico Gold
MAR = Marriott International
KORS = Michael Kors
MRVL = Marvell
CPB = Campbell Soup
ILMN = Illumina
GMCR = GMCR
SWN = Southwestern Energy
AEO = American Eagle Outfitters
MCP = Molycorp
P = Pandora
PSEC = Prospect Capital
AEE = Ameren
JNJ = J & J
YHOO = Yahoo!
LVS = LV Sands
SNE = Sony
MMM = 3M
GME = GameStop
MFC = Manulife
HLF = Herbalife
HERO = Hercules Offshore
INFY = Infosys
LNG = Cheniere Energy
NOV = National-Oilwell
HFC = HollyFrontier
WLT = Walter Energy
GG = Goldcorp
HRB = H&R Block
ESV = ENSCO PLC
EBAY = eBay
LEN = Lennar
TIBX = Tibco Software
MGM = MGM
BBRY = BlackBerry
RF = Regions Financial
BAC = Bank Of America
MCD = McDonald's
ALTR = Altera
DVN = Devon Energy
CTSH = Cognizant
EA = Electronic Arts
MPEL = Melco Crown Entertainment
MAT = Mattel
TSO = Tesoro
FE = FirstEnergy
TS = Tenaris
PEP = PepsiCo
MSFT = Microsoft
TSN = Tyson Foods
CAT = Caterpillar
BMY = Bristol Myers
JOY = Joy Global
SLB = Schlumberger
CHS = Chico's FAS
CVS = CVS Caremark
RRD = RR Donnelley
HIMX = Himax Technologies
RAI = Reynolds American
ADBE = Adobe
UAL = United Continental
PLCM = Polycom
HSH = Hillshire Brands
COP = ConocoPhillips
DIS = Walt Disney
BRK.B = Berkshire Hathaway
CBI = Chicago Bridge & Iron
CHK = Chesapeake Energy
PTEN = Patterson-UTI Energy
SO = Southern Company
ANF = Abercrombie & Fitch
TRI = T. Reuters
RSG = Republic Services
NKE = Nike
AGN = Allergan
DRYS = DryShips
IGT = International Game Technology
CAR = Avis Budget
PCL = Plum Creek Timber Co  REIT
TSM = Taiwan Semi.
NKTR = Nektar Therapeutics
AMCC = Applied Micro Circuits
ABBV = AbbVie
PPL = PPL
CBG = CBRE
HK = Halcon Resources
JCP = J.C. Penney
AMAT = Applied Mat.
LB = Brands
MDR = McDermott International
WETF = WisdomTree Investments
MFA = MFA Financial
BEN = Franklin
DFS = Discover Financial
IBM = IBM
KO = Coca Cola
DISCA = Discovery Communications
SPLS = Staples
WAG = Walgreens
AMT = American Tower
DWA = Dreamworks Animation
SNH = Senior Housing Properties Trust
VVUS = VIVUS
SLM = SLM
FNSR = Finisar
CNQ = Canadian Natural Resource
COF = Capital One
CSCO = Cisco
SWHC = Smith & Wesson Holding
EGO = Eldorado Gold
NTAP = NetApp
ITUB = Itau Unibanco
FCX = FCX
CHL = China Mobile
NBL = Noble Energy
BEE = Strategic Hotels & Resorts
WMT = Wal-Mart
DTV = DirecTV
DG = Dollar General
GGP = General Growth Properties
CTRP = Ctrip
KR = The Kroger Co.
ALXN = Alexion
NPSP = NPS Pharmaceuticals
VTR = Ventas
HPQ = HP
RAD = Rite Aid
QCOM = Qualcomm
SUNE = SunEdison
MET = MetLife
TRIP = Tripadvisor
PAY = VeriFone
NWSA = News Corp
NCR = NCR
CRM = salesforce.com
DHR = Danaher
FDX = FedEx
HUN = Huntsman
MO = Altria
TTWO = Take-Two Interactive Software
PAAS = Pan American Silver
PBR = Petrobras
WFM = Whole Foods
WEN = Wendy's Company
APOL = Apollo Group
YNDX = Yandex
VIP = VimpelCom
CIEN = CIENA
INFA = Informatica
BRCM = Broadcom
KERX = Keryx Biopharmaceuticals
COST = Costco
CCJ = Cameco
EXC = Exelon
AWAY = HomeAway
APA = Apache
ARMH = ARM Holdings
ADI = Analog Devices
V = Visa
MWW = Monster Worldwide
MNST = Monster Beverage
AIG = AIG
CVX = Chevron
SINA = Sina
HMC = Honda
HUM = Humana
HCBK = Hudson City Bancorp
LMT = Lockheed Mart.
AEP = AEP
TD = TD Bank
BLMN = Bloomin' Brands
CDNS = Cadence Design Systems
ADT = ADT
IBN = ICICI Bank
CRUS = Cirrus Logic
DNR = Denbury Resources
CTL = CenturyLink
CMCSA = Comcast
SPLK = Splunk
URI = United Rentals
FTR = Frontier
WFC = Wells Fargo
DLTR = Dollar Tree
TOL = Toll Brothers
F = Ford
ATML = Atmel
CNX = CONSOL Energy
K = Kellogg
ATVI = Activision
PSX = Phillips 66
LLY = Eli Lilly
COTY = Coty
LO = Lorillard
AET = Aetna
ARUN = Aruba Networks
UTX = UTX
MW = Mens Wearhouse
GM = General Motors
S = Sprint Nextel
NSU = Nevsun Resources
ETFC = E TRADE
ALL = The Allstate
GS = GoldmanSachs
HST = Host Hotels
UDR = UDR
AA = Alcoa
SU = Suncor Energy
TLM = Talisman Energy
LUV = Southwest Airlines
MOS = Mosaic
BBBY = BBBY
MS = Morgan Stanley
AGNC = American Capital Agency
X = United States Steel
TMUS = T-Mobile
GNC = GNC Holdings
DNKN = Dunkin Brands
ARO = Aeropostale
RKUS = Ruckus Wireless
TIVO = TiVo
NWL = Newell Rubbermaid
AOL = AOL
ASNA = Ascena Retail
ANR = ANR
URBN = Urban Outfitters
MYGN = Myriad Genetics
MTG = MGIC Investment
PCLN = Priceline
ORLY = O'Reilly
PHM = PulteGroup
EWBC = East West Bancorp
CBS = CBS
ACI = Arch Coal
COH = Coach
O = Realty ome
NRG = NRG Energy
CLF = Cliffs Natural Resources
AFL = AFLAC Incorporated
AES = The AES
SHLD = Sears Holdings
BIDU = Baidu
STZ = Constellation Brands
PFE = Pfizer
GPK = Graphic Packaging
DLPH = Delphi Automotive
TRQ = Turquoise Hill Resources
BIIB = Biogen Idec
AMD = AMD
BBT = BB&T
SRCL = Stericycle
GPS = Gap
DE = Deere
CA = CA
BRCD = Brocade
WFT = Weatherford
CL = Colgate-Palmolive
BTU = Peabody Energy
APD = APD
TJX = The TJX Companies
CAH = Cardinal Health
KMB = Kimberly Clark
FIS = Fidelity
FNF = Fidelity National Financial
RENN = Renren
IMO = Imperial Oil
NCT = Newcastle Investment
EXAS = EXACT Sciences
VMW = VMware
WBS = Webster Financial
HON = Honeywell
JNPR = Juniper Networks
MHR = Magnum Hunter Resources
POM = Pepco
CBL = CBL & Associates
BDX = BDX
ODP = Office Depot
MCK = McKesson
M = Macy's
UNP = UNP
PHYS = Sprott Physical Gold Trust
WM = Waste Management
SNV = Synovus Financial
DOW = DOW
SD = SandRidge Energy
GCI = Gannett Co.
VZ = Verizon
NOW = ServiceNow
SYK = Stryker
KRFT = Kraft Foods
SCCO = S.Copper
FISV = Fiserv
OXY = Occidental
USB = US Bancorp
ABX = Barrick Gold
BRFS = BRF
LRCX = Lam Research
KEY = KeyCorp
HAL = Halliburton
ECA = EnCana
BBY = Best Buy Co.
VALE = Vale
CX = Cemex
GNW = Genworth Financial
IDTI = IDT
TXN = Texas Inst.
PRU = Prudential Financial
AON = Aon
EXPE = Expedia
CVE = Cenovus
JBL = Jabil Circuit
TIF = Tiffany
TEX = Terex
BRO = Brown & Brown
PANW = Palo Alto Networks
ABC = AmerisourceBergen
WY = Weyerhaeuser
PM = Philip Morris
KMI = Kinder Morgan
NVDA = NVIDIA
UPL = Ultra Petroleum
JNS = Janus Capital Group
DD = DuPont
AVGO = Avago Technologies
BK = BK
MYL = Mylan
HD = Home Depot
ZTS = Zoetis
PXD = Pioneer Natural Resources
HCP = HCP
TGT = Target
PIR = Pier 1 Imports
SYY = SYSCO
LINTA = Liberty Media
AMTD = TD Ameritrade
COG = Cabot Oil & Gas
SNP = China Petro.
LYB = LyondellBasell Industries
ACE = ACE
DISH = DISH Network
VRX = Valeant
AUY = Yamana Gold
CSC = Computer Sciences
CHU = China Unicom
BMO = BMO
SDRL = SeaDrill Limited
IPG = IPG - interpublic
XL = XL
HRL = Hormel Foods
FL = Foot Locker
BCE = BCE
LKQ = LKQ
XOM = Exxon
AEM = Agnico-Eagle Mines
MXIM = Maxim
SIAL = Sigma-Aldrich
PG = P&G
RY = RBC
ORCL = Oracle
CAM = Cameron
CTRX = Catamaran
PAYX = Paychex
BLK = BlackRock
SPG = Simon Property
WLP = WellPoint
MDLZ = Mondelēz
CFN = CareFusion
ESRX = Express Scrip.
VRTX = Vertex
ROST = Ross Stores
WSM = Williams-Sonoma
HOLX = Hologic
OAS = Oasis Petroleum
A = Agilent Technologies
FRX = Forest Laboratories
ARCP = American Realty Capital Props
CREE = Cree
FMER = FirstMerit
NI = NiSource
BAX = Baxter
RFMD = RF Micro Devices
CIT = CIT Group
HES = Hess
STX = Seagate
AINV = Apollo Investment
WU = Western Union
EOG = EOG
GIS = General Mills
SEE = Sealed Air
RAX = Rackspace Hosting
INTU = Intuit
LOW = Lowe's
KBR = KBR
AKAM = Akamai
ACAS = American Capital
ADSK = Autodesk
DDR = DDR
FHN = First Horizon National
HT = Hersha Hospitality Trust
FFIV = F5 Networks
CNO = CNO Financial Group
SBAC = SBA Communications
ONNN = ON Semiconductor
TRMB = Trimble Navigation
ADP = ADP
AIV = Aimco
ACN = Accenture
NBR = Nabors Industries
ABT = Abbott
MSI = Motorola
MCHP = Microchip
CPN = Calpine
HCN = Health Care REIT
QGEN = Qiagen
QLGC = QLogic
CELG = Celgene
EMR = Emerson
KSS = Kohl's
CTB = Cooper Tire & Rubber
FITB = Fifth Third Bancorp
L = Loews
D = Dominion
CAJ = Canon
WDC = Western Digital
DUK = Duke Energy
ARCC = Ares Capital
NUAN = Nuance
IVZ = Invesco
MDT = Medtronic
JBLU = JetBlue Airways
ELNK = EarthLink
JDSU = JDS Uniphase
FLEX = Flextronics
ED = Consolidated Edison
MDRX = Allscripts Healthcare Solutions
CMS = CMS Energy
CENX = Century Aluminum
NXPI = NXP Semiconductors
TWO = Two Harbors Investment
CTXS = Citrix Systems
ADM = Archer Daniels
AXP = AMEX
PDS = Precision Drilling
BAM = Brookfield
CCL = Carnival
ISRG = Intuitive Surgical
ETN = Eaton
AGO = Assured Guaranty
CMA = Comerica Incorporated
RVBD = Riverbed
DAN = Dana Holding
DF = Dean Foods Company
CYS = CYS Investments
RDN = Radian Group
FLR = Fluor
AVP = Avon Products
SWY = Safeway
IP = International Paper Co
NSC = NScorp
YUM = Yum!
KOG = Kodiak Oil & Gas
AMP = Ameriprise Financial
AKS = AK Steel
MON = Monsanto
WSH = Willis Group Holdings
MCO = Moody's
BPO = Brookfield Office
PLD = Prologis
BSX = Boston Scientific
STLD = Steel Dynamics
EPD = Enterprise Prod.
KGC = Kinross Gold
BHI = Baker Hughes
FIO = Fusion-io
SPF = Standard Pacific
GLW = Corning
TTEK = Tetra Tech
BX = The Blackstone
DHI = D.R. Horton
CE = Celanese
HOV = Hovnanian Enterprises
VIA.B = Viacom
CY = Cypress Semiconductor
MA = MasterCard
SE = Spectra Energy
MPC = Marathon Petroleum
TXT = Textron
PBI = Pitney Bowes
NEE = NextEra Energy
SPN = Superior Energy Services
VLO = Valero Energy
CMI = Cummins
OI = Owens-Illinois
EIX = Edison International
MAS = Masco
LUK = Leucadia National
MRO = Marathon Oil
OKE = ONEOK
NRF = Northstar Realty Finance
PBCT = People's United Financial
THC = Tenet Healthcare
ZION = Zions Ban
VRSN = VeriSign
HIG = HIG
FNFG = First Niagara Financial
HCA = HCA Holdings
CME = CME
KLAC = KLA-Tencor
DCM = NTT DoCoMo
KBH = KB Home
TYC = Tyco International
RHT = Red Hat
DTE = DTE Energy Co
STT = State Street
UPS = UPS
XLNX = Xilinx
NFX = Newfield
SVU = Supervalu
UNM = Unum
BMR = BioMed Realty Trust
WMB = Williams Companies
WIN = Windstream
XRX = Xerox
PWE = Penn West
AMGN = Amgen
COV = Covidien
EMC = EMC
PX = Praxair
QEP = QEP Resources
UNH = UnitedHealth
LPX = Louisiana-Pacific
PNC = PNC Financial
TE = TECO Energy
WEC = Wisconsin Energy
ENB = Enbridge
NLSN = Nielsen Holdings
LLTC = Linear Tech.
STJ = St. Jude Medical
EXPD = EXPD
ATI = Allegheny Technologies
CCI = Crown Castle International
XEL = Xcel Energy
CSX = CSX
NTRS = Northern Trust
FLIR = FLIR
PWR = Quanta Services
CNP = CenterPoint Energy
TRV = The Travelers Companies
FAST = Fastenal
NUE = Nucor
PEG = Public Service
TCK = Teck
XRAY = DENTSPLY
LM = Legg Mason
SCHW = Charles Schwab
LXP = Lexington Realty Trust
CB = The Chubb
JCI = Johnson Controls
FTNT = Fortinet
CI = CIGNA
PCAR = PACCAR
CVC = Cablevision Systems
PCG = PG&E
MHP = McGraw-Hill
LNC = Lincoln National
WPX = WPX Energy
KMX = CarMax
WLL = Whiting Petroleum
HL = Hecla Mining
IR = Ingersoll-Rand
CAG = ConAgra Foods
NLY = Annaly Capital M.
RCL = RC Cruises
BXP = Boston Properties
CERN = Cerner
HBAN = HBAN
ICE = ICE
GD = General Dynamics
IVR = Invesco Mortgage Capital
SHO = Sunstone Hotel Investors
TCRD = THL Credit
RTN = Raytheon
MJN = Mead Johnson Nutrition
RCI = Rogers Communications
WPZ = Williams Partners
BNS = BNS
POT = Potash
CIM = Chimera Investment
LINE = Linn Energy
EQR = Equity Residential
MMC = MMC
HOT = Starwood
NOC = Northrop Grumman
SUSQ = Susquehanna Bancshares
TROW = T. Rowe Price
TMO = TMO
ARR = ARMOUR Residential REIT
LEG = Leggett & Platt
PGR = The Progressive
OC = Owens Corning
PMCS = PMC - Sierra
ITW = Illinois TW
KIM = Kimco Realty
TRP = TransCanada
CHT = Chunghwa Tele.
TER = Teradyne
STI = SunTrust Banks
HSIC = Henry Schein
TU = TELUS
NYCB = NY Bancorp
PFG = Principal Financial
DRE = Duke Realty
TMHC = Taylor Morrison Home
GCC.IR = C&C
CRG.IR = CRH
KRZ.IR = Kerry Group
KRX.IR = Kingspan
PLS.IR = Paddy Power
RY4B.IR = RyanAir
SK3.IR = Smurfit Kappa
RRL.AX = Regis Resources
CCL.AX = Coca-Cola Amatil
MIN.AX = Mineral Resources
FXJ.AX = Fairfax Media
SUL.AX = Super Retail Group
BHP.AX = BHP Billiton
DOW.AX = Downer Edi
ORI.AX = Orica
MND.AX = Monadelphous
IRE.AX = IRESS
WPL.AX = Woodside Petroleum
MRM.AX = Mermaid Marine
ASX.AX = ASX
MSB.AX = Mesoblast
BDR.AX = Beadell Resources
RIO.AX = Rio Tinto
FLT.AX = Flight Centre
KAR.AX = Karoon
OSH.AX = Oil Search
TLS.AX = Telstra
AZJ.AX = Aurizon
AGO.AX = Atlas Iron
COH.AX = Cochlear
ALZ.AX = Australand
QAN.AX = Qantas Airways
MYR.AX = Myer
SFR.AX = Sandfire Resources
WOW.AX = Woolworths
UGL.AX = UGL
SAI.AX = SAI Global
IFL.AX = IOOF
SXY.AX = Senex Energy
SXL.AX = Southern Cross Media
TOL.AX = Toll Holdings
TSE.AX = Transfield Services
SKE.AX = Skilled Group
WTF.AX = Wotif
OZL.AX = OZ Minerals
ALL.AX = Aristocrat
BKN.AX = Bradken
ALQ.AX = ALS
CSR.AX = CSR
SUN.AX = Suncorp-Metway
JHX.AX = James Hardie
ARI.AX = Arrium
WHC.AX = Whitehaven Coal
DUE.AX = DUET
CGF.AX = Challenger
BPT.AX = Beach Energy
TWE.AX = Tresaury Wine Estates
NCM.AX = Newcrest Mining
FMG.AX = Fortescue Metals
EGP.AX = Echo Entertainment
PRY.AX = Primary
GWA.AX = GWA
LEI.AX = Leighton
DLS.AX = Drillsearch Energy
CBA.AX = CBA
AMP.AX = AMP
IAG.AX = Insurance Australia
AWC.AX = Alumina
MTU.AX = M2
PNA.AX = Panaust
CRZ.AX = carsales
VAH.AX = Virgin Australia
MGX.AX = Mount Gibson Iron
MMS.AX = Mcmillan Shakespeare
HGG.AX = Henderson
AQA.AX = Aquila Resources
BOQ.AX = Bank of Queensland
AUT.AX = Aurora
MQG.AX = Macquarie
BEN.AX = BEN
WBC.AX = WBC
ANZ.AX = ANZ
ORG.AX = Origin Energy
PTM.AX = Platinum MGM
GFF.AX = Goodman Fielder
STO.AX = Santos
ILU.AX = Iluka Resources
JBH.AX = JB Hi-Fi
CPU.AX = Computershare
IIN.AX = iiNET
APA.AX = APA
PPT.AX = Perpetual
FDC.AX = Federation Centres
TPM.AX = TPG
RHC.AX = Ramsay Health Care
DLX.AX = DuluxGroup
DJS.AX = David Jones
WOR.AX = Worleyparsons
CDD.AX = Cardno
SEK.AX = Seek
CTX.AX = Caltex Australia
NUF.AX = Nufarm
WES.AX = Wesfarmers
SGM.AX = SGM
NVT.AX = Navitas
WDC.AX = Westfield
CSL.AX = CSL
MTS.AX = Metcash
IGO.AX = Independence Group
BSL.AX = BlueScope Steel
AMC.AX = Amcor
QBE.AX = QBE Insurance
SYD.AX = Sydney Airport
QUB.AX = Qube
BRG.AX = Breville Group
LLC.AX = Lend Lease
FXL.AX = Flexigroup
SVW.AX = Seven Holdings
AGK.AX = AGL Energy
MQA.AX = MQA
AIO.AX = Asciano
SWM.AX = Seven West Media
SKI.AX = Spark
CWN.AX = Crown
NAB.AX = NAB
GNC.AX = Graincorp
IPL.AX = Incitec Pivot
BXB.AX = Brambles
ANN.AX = Ansell
AWE.AX = AWE
TPI.AX = Transpacific Industries
RMD.AX = Resmed
WRT.AX = Westfield Retail
TAH.AX = Tabcorp
FBU.AX = Fletcher Building
SHL.AX = Sonic healthcare
SGP.AX = Stockland
TEL.AX = Telecom NZ
HVN.AX = Harvey Norman
AAD.AX = Ardent Leisure
MGR.AX = Mirvac
IOF.AX = ING Office Fund
CFX.AX = CFS Retail
CHC.AX = Charter Hall
CQR.AX = Charter Hall Reit
TCL.AX = Transurban
BWP.AX = BWP Trust
GMG.AX = Goodman Group
DXS.AX = Dexus Property
SPN.AX = SP AusNet
IVC.AX = InvoCare
ABP.AX = Abacus
TTS.AX = Tatts Group
LHA.DE = D. Lufthansa
DBK.DE = Deutsche Bank
AIR.PA = Airbus
SZU.DE = Suedzucker
ADS.DE = Adidas
VOW.DE = Volkswagen
DEZ.DE = Deutz
GBF.DE = Bilfinger Berger
GWI1.DE = Gerry Weber International
DAI.DE = Daimler
S92.DE = SMA Solar Technology
SIE.DE = Siemens
MRK.DE = Merck
RWE.DE = RWE
KU2.DE = KUKA
TKA.DE = ThyssenKrupp
AIXA.DE = Aixtron SE NA
FME.DE = Fresenius Med
SY1.DE = Symrise
MEO.DE = Metro
SOW.DE = Software
BMW.DE = BMW
CBK.DE = Commerzbank
NDA.DE = Aurubis
FNTN.DE = Freenet
DLG.DE = Dialog Semiconductor
SDF.DE = K+S
MAN.DE = MAN
ARL.DE = Aareal Bank
SAP.DE = SAP
KCO.DE = Klockner
IFX.DE = Infineon
PAH3.DE = Porsche
ALV.DE = Allianz
TEG.DE = T Immobilien
DPW.DE = Deutsche Post
BNR.DE = Brenntag
LIN.DE = Linde
MOR.DE = Morphosys
UTDI.DE = United Internet
PSM.DE = ProSiebenSat.1
SKYD.DE = Sky Deutschland
EOAN.DE = E.ON
MTX.DE = MTU
BAYN.DE = Bayer
SGL.DE = SGL
SPR.DE = Axel Springer
RHM.DE = Rheinmetall
ZIL2.DE = ElringKlinger
DTE.DE = Deutsche Telekom
DRW3.DE = Drägerwerk
FRE.DE = Fresenius
G1A.DE = GEA
WIN.DE = Wincor Nixdorf
BEI.DE = Beiersdorf
MUV2.DE = Munich Re
RHK.DE = Rhoen Klinikum
PFV.DE = Pfeiffer Vacuum
RAA.DE = Rational
SAZ.DE = Stada Arzneimittel
HOT.DE = Hochtief
BAS.DE = BASF
CON.DE = Continental
PUM.DE = Puma
TUI1.DE = TUI
GXI.DE = Gerresheimer
WCH.DE = Wacker
WDI.DE = Wirecard
DWNI.DE = Deutsche Wohnen
DEQ.DE = Deutsche Euroshop
VOS.DE = Vossloh
HEI.DE = Heidel. Cement
QIA.DE = QIEN
DB1.DE = DeutscheBörse
LEO.DE = LEONI
HNR1.DE = Hannover Re
NOEJ.DE = NORMA Group
HEN3.DE = Henkel
KD8.DE = Kabel Deutschland
LXS.DE = LANXESS
DUE.DE = Duerr
GIB.DE = GSW Immobilien
BOSS.DE = Hugo Boss
FRA.DE = Fraport
SZG.DE = Salzgitter
CLS1.DE = Celesio
GFJ.DE = GFAH
FPE3.DE = Fuchs Petrolub
UG.PA = Peugeot Citroën
ML.PA = Michelin
VK.PA = Vallourec
ALU.PA = Alcatel-Lucent
TEC.PA = Technip
BNP.PA = BNP Paribas
AF.PA = Air France-KLM
AIR.PA = Airbus
EN.PA = Bouygues
EDF.PA = EDF
DSY.PA = Dassault System
SAN.PA = Sanofi-aventis
TCH.PA = Technicolor
VIE.PA = Veolia
POM.PA = Plastic Omnium
SEV.PA = Suez
MMB.PA = Lagardere
OR.PA = Loreal
UBI.PA = Ubisoft
GLE.PA = Société Générale
GFC.PA = Gecina
RCO.PA = Remy Cointreau
ACA.PA = Crédit Agricole
ETL.PA = Eutelsat
MAU.PA = Maurel et Prom
RXL.PA = Rexel
ELE.PA = Euler Hermes
CGG.PA = CGG - Veritas
BB.PA = Bic
GSZ.PA = GDF Suez
STM-I = STMicroelectronics
ILD.PA = Iliad
ALO.PA = Alstom
NEO.PA = Neopost
AI.PA = Air Liquide
KN.PA = Natixis
BN.PA = Danone
FR.PA = Valeo
AC.PA = Accor
ATO.PA = Atos Origin
SGO.PA = Saint-Gobain
ORA.PA = FranceTelekom_Name
CA.PA = Carrefour
FDR.PA = Fonc des Regions
VIV.PA = Vivendi
IPN.PA = Ipsen
PUB.PA = Publicis
EO.PA = Faurecia
RF.PA = Eurazeo
EI.PA = Essilor
GBB.PA = Bourbon
FGR.PA = Eiffage
RCF.PA = Teleperformance
DEC.PA = JCDecaux
RNO.PA = Renault
UL.AS = Unibail-Rodamco
ERA.PA = Eramet
NEX.PA = Nexans
HAV.PA = Havas
RAL.PA = Rallye
RUI.PA = Rubis SCA
MERY.PA = Mercialys
IPS.PA = Ipsos
TFI.PA = TF1
FP.PA = Total
ATE.PA = Alten
ING.PA = Ingenico
RMS.PA = Hermes Intl
CS.PA = Axa
KER.PA = PPR
GTO.PA = Gemalto
RI.PA = Pernod Ricard
RIA.PA = Steria
LI.PA = Klepierre Reit
MC.PA = LVMH
LG.PA = Lafarge
SAF.PA = Safran
SW.PA = Sodexo
BVI.PA = Bureau Veritas
EDEN.PA = Edenred
SAFT.PA = Saft Groupe
HO.PA = Thales
ZC.PA = Zodiac
BIM.PA = Biomerieux
GET.PA = Groupe Eurotunnel
ADP.PA = Adp promesses
SU.PA = Schneider  Electric
ORP.PA = Orpea
NXI.PA = Nexity
AKE.PA = Arkema
CDI.PA = Christian Dior
ALT.PA = Altran Technologies
CO.PA = Casino
ICAD.PA = Icade
LR.PA = Legrand
NK.PA = Imerys
SCR.PA = Scor
CAP.PA = Capgemini
MMT.PA = M6 Metropole Tel
SESG.PA = SES
DG.PA = Vinci
ERF.PA = Eurofins Scientific
MF.PA = Wendel
CNP.PA = CNP Assurances
VCT.PA = VICAT
A2A-I = A2A
STS-I = Ansaldo
ATL-I = Atlantia
AGL-I = Autogrill
AZM-I = Azimut Holding
BGN-I = Banca Generali
BP-I = B. Popolare
BMPS-I = BMPS
BZU-I = Buzzi Unicem
CPR-I = Campari
DAN-I = Danieli & C
DLG-I = De'Longhi
DIA-I = DiaSorin
EGPW-I = E.Green Power
ENEL-I = Enel
ENI-I = Eni
ERG-I = ERG
EXO-I = Exor
F-I = Fiat
CNHI-I = CNH Industrial
FNC-I = Finmeccanica
G-I = Generali
GEO-I = Geox
BPE-I = Grupo BPER
GTK-I = GTECH
SAL-I = Salini Impregilo
IND-I = Indesit
ISP-I = Intesa
IT-I = Italcementi
LUX-I = Luxottica
MS-I = Mediaset
MB-I = Mediobanca
MED-I = Mediolanum
PIA-I = Piaggio & C
PC-I = Pirelli
PRY-I = Prysmian
REC-I = Recordati
SPM-I = Saipem
SFER-I = Salvatore Ferragamo Italia
SRG-I = Snam
STM-I = STMicroelectronics
TIT-I = Telecom Italia
TEN-I = Tenaris
TRN-I = Terna - Rete
TOD-I = Tods
UBI-I = UBI
UCG-I = UniCredit
UNI-I = Unipol
YOOX-I = Yoox
0017.HK = New World Dev
0700.HK = Tencent
0012.HK = Henderson Land
0270.HK = Guangdong Investment
0330.HK = ESPRIT
0392.HK = Beijing Enterprises
0148.HK = Kingboard Chemical
0291.HK = China Resources
0003.HK = HK & China Gas
0639.HK = Shougang Fushan Resources
0489.HK = Dongfeng Motor
0762.HK = China Unicom
0868.HK = Xinyi Glass
0813.HK = Shimao Property
0914.HK = Anhui Conch Cement
0728.HK = China Telecom
1199.HK = COSCO Pacific
0857.HK = PetroChina
0005.HK = HSBC
0004.HK = Wharf
0494.HK = Li & Fung
2628.HK = China Life
0606.HK = China Agri-Industries
0293.HK = Cathay Pacific
2318.HK = Ping An
0656.HK = Fosun International
0101.HK = Hang Lung
0902.HK = Huaneng Power
1044.HK = Hengan Int'l
0388.HK = HKEx
1880.HK = Belle Int'l
1898.HK = China Coal
0691.HK = China Shanshui Cement
0916.HK = China Longyuan Power
0941.HK = China Mobile
0011.HK = Hang Seng Bank
0002.HK = CLP
0881.HK = Zhongsheng Group
0688.HK = China overseas
0001.HK = Cheung Kong
0168.HK = Tsingtao Brewery
0151.HK = Want Want China
0390.HK = China Railway
1109.HK = China Res Land
0836.HK = CR Power
0631.HK = Sany Heavy Equipment
0763.HK = ZTE
0386.HK = Sinopec
0013.HK = HWL
3328.HK = Bankcomm
0006.HK = Power Assets
3988.HK = Bank Of China
0267.HK = CITIC Pacific
1299.HK = AIA
2600.HK = CHALCO
0023.HK = Bank of E.Asia
0135.HK = Kunlun Energy
0410.HK = Soho China Ltd.
0175.HK = Geely Automobile
0883.HK = CNOOC
0144.HK = China Mer Hold
0336.HK = Huabao International
0817.HK = Franshion Properties
2388.HK = BOC
0322.HK = Tingyi
0683.HK = Kerry Properties
1088.HK = China Shenhua
0016.HK = SHK
0363.HK = Shanghai Industrial
1398.HK = ICBC
0939.HK = CCB
0358.HK = Jiangxi Copper
0019.HK = Swire Pacific
0066.HK = MTR
0083.HK = Sino Land
AALB.AS = Aalberts Industries
AGN.AS = Aegon
AH.AS = Ahold
AF.PA = Air France-KLM
AKZA.AS = AkzoNobel
APAM.AS = Aperam
ARCAD.AS = ARCADIS
MT.AS = ArcelorMittal
ASM.AS = ASM
ASML.AS = ASML
BAMNB.AS = BAM
BINCK.AS = BinckBank
BOKA.AS = Boskalis
BRNL.AS = Brunel
CORA.AS = Corio
CRBN.AS = csm
DL.AS = Delta lloyd
DSM.AS = DSM
ECMPA.AS = Eurocommercial
FUR.AS = Fugro
HEIA.AS = Heineken
IM.AS = Imtech
INGA.AS = ING
KPN.AS = KPN
NUO.AS = nutreco
PHIA.AS = Philips
PNL.AS = PostNL
RAND.AS = Randstad
RDSA.AS = RDS
REN.AS = Reed Elsevier
SBMO.AS = SBM Offshore
KTC.AS = TenCate
TNTE.AS = TNT Express
TOM2.AS = TomTom
UL.AS = Unibail-Rodamco
UNIA.AS = Unilever
USG.AS = USG People
VASTN.AS = Vastned
VPK.AS = Vopak
WER.SG = Wereldhave
WKL.AS = Wolters Kluwer
ZIGGO.AS = Ziggo
AMEAS = Amer Sports
CGCBV = Cargotec
ELI1V = Elisa
FUM1V = Fortum
HUH1V = Huhtamaki
KRA1V = Kemira
KESBV = Kesko
KNEBV = Kone
KCR1V = Konecranes
MEO1V = Metso
NES1V = Neste Oil
NOK1V = Nokia
NRE1V = NokianRenkaat
NDA1V = Nordea Bank
ORNBV = Orion
OTE1V = Outotec
POH1S = Pohjola Pankki
RTRKS = Rautaruukki
SAMAS = Sampo
SAA1V = Sanoma
SDA1V = Sponda
STERV = Stora Enso
TLS1V = TeliaSonera
TIE1V = Tieto
UPM1V = UPM
WRTBV = Wärtsilä
YTY1V = YIT
ABI.BR = AB Inbev
ACKB.BR = Ackermans
AGS.BR = Ageas
BEFB.BR = Befimmo
BEKB.BR = Bekaert
BELG.BR = Belgacom
COFB.BR = Cofinimmo
COLR.BR = Colruyt
DIE.BR = D'ieteren
DELB.BR = Delhaize Group
GBLB.BR = GBL
GSZ.PA = GDF Suez
KBC.BR = KBC Group
MOBB.BR = Mobistar
SOLB.BR = Solvay
TNET.BR = Telenet
TESB.BR = Tessenderlo Chemie
THR.BR = ThromboGenics
UCB.BR = UCB
UMI.BR = Umicore
CARL-B.CO = Carlsberg
CHR.CO = Chr. Hansen
COLO-B.CO = Coloplast
DANSKE.CO = Danske Bank
DSV.CO = DSV
FLS.CO = FLSmidth
GN.CO = GN Store
LUN.CO = H Lundbeck
JYSK.CO = Jyske Bank
MAERSK-B.CO = Maersk
NKT.CO = NKT Holding
DNORD.CO = D/S Norden
NOVO-B.CO = Novo Nordisk
NZYM-B.CO = Novozymes
PNDORA.CO = PANDORA A/S
SYDB.CO = Sydbank
TDC.CO = TDC
TOP.CO = Topdanmark
TRYG.CO = Tryg
VWS.CO = Vestas
WDH.CO = WilliamDemant
ABB.ST = ABB
ALFA.ST = Alfa Laval
ASSA-B.ST = Assa Abloy
AZN.ST = AstraZeneca
ATCO-A.ST = Atlas Copco
ALIV.ST = Autoliv Inc
BOL.ST = Boliden
CAST.ST = Castellum
ELUX-B.ST = Electrolux
EKTAB.ST = Elekta
ERIC-B.ST = Ericsson
FABG.ST = Fabege
GETI-B.ST = Getinge
HM-B.ST = H&M
ICA.ST = ICA Gruppen
SHB-A.ST = Handelsbanken
HEXA-B.ST = Hexagon
HOLM-B.ST = Holmen
HUFV-A.ST = Hufvudstaden
HUSQB.ST = Husqvarna
INDUC = Industrivarden
IJ.ST = Intrum Justitia
KINV-B.ST = Investment Kinnevik
INVE-B.ST = Investor
JM.ST = JM
LOOM-B.ST = Loomis
LUMI.ST = Lundin Mining
LUPE.ST = Lundin Petroleum
MEDAA.ST = Meda
MIC.ST = Millicom
MTG-B.ST = Modern Times
NCC-B.ST = NCC
NOKI.ST = Nokia
NDA-SEK.ST = Nordea Bank
ORI-SDB.ST = Oriflame Cosmetics
RATO-B.ST = Ratos
SAND.ST = Sandvik
SCA-B.ST = SCA
SCV-B.ST = Scania
SEB-A.ST = SEB
SECU-B.ST = Securitas
SKA-B.ST = Skanska
SKF-B.ST = SKF
SSAB-A.ST = SSAB
STER.ST = Stora Enso
SWED-A.ST = Swedbank
SWMA.ST = Swedish Match
TEL2-B.ST = Tele2
TLSN.ST = TeliaSonera
TRELB.ST = Trelleborg
VOLV-A.ST = Volvo
ABBN.VX = ABB
ATLN.VX = Actelion
ADEN.VX = Adecco
ARYN.SW = Aryzta
BALN.vx = Baloise
CLN.VX = Clariant
CSGN.VX = Credit Suisse
DUFN.SW = Dufry
GALN.SW = Galenica
GAM.SW = GAM Holding
GEBN.VX = Geberit
FI-N.SW = Georg Fischer
GIVN.VX = Givaudan
HELN.SW = Helvetia
HOLN.VX = Holcim
BAER.VX = Julius Baer
KNIN.vx = Kuehne + Nagel
LOGN.SW = Logitech
LONN.VX = Lonza
MBTN.SW = Meyer Burger
NESN.VX = Nestlé
NOBN.vx = Nobel Biocare
NOVN.VX = Novartis
PWTN.SW = Panalpina Welttransport
PARG.SW = Pargesa
PGHN.SW = Partners
PSPN.SW = PSP Swiss
CFR.VX = Richemont
ROG.VX = Roche
SCHP.VX = Schindler
SGSN.VX = SGS
SIK.SW = Sika
SOON.vx = Sonova
STMN.SW = Straumann
SUN.SW = Sulzer
UHR.VX = Swatch
SLHN.VX = Swiss Life
SPSN.SW = Swiss Prime Site
SREN.VX = Swiss Re
SCMN.VX = Swisscom
SYNN.VX = Syngenta
TEMN.SW = Temenos
RIGN.VX = Transocean
UBSN.VX = UBS
VATN.SW = Valiant
ZURN.VX = Zurich Financial
ANDR.VI = Andritz
ATRS.VI = Atrium
CWI.VI = Conwert
EBS.VI = Erste Group
IIA.VI = Immofinanz
OMV.F = OMV
RBI.VI = Raiffeisen
RHI.VI = RHI
SBO.VI = Schoeller-Bleck
TKA.VI = Telekom Austria
VER.VI = Verbund
VIG.VI = VIG
VOE.VI = Voestalpine
WIE.VI = WienerBerger
ZAG.VI = Zumtobel
ABE.MC = Abertis
ANA.MC = Acciona
ACX.MC = Acerinox
ACS.MC = ACS
AMS.MC = Amadeus IT Holding
MT.AS = ArcelorMittal
SAB.MC = Banco de Sabadell
POP.MC = Banco Popular
BKT.MC = Bankinter
BBVA.MC = Bbva
BME.MC = BME
CABK.MC = Caixabank
DIA.MC = DIA
EBRO.MC = Ebro Foods
ENG.MC = Enagás
ELE.MC = Endesa
FER.MC = Ferrovial
FCC.MC = Fomento
GAM.MC = Gamesa
GAS.MC = Gas Natural
TL5.MC = Gestevision Telecinco
GRF.MC = Grifols
OHL.MC = Grupo OHL
IAG.MC = IAG
IBE.MC = Iberdrola
ITX.MC = Inditex
IDR.MC = Indra Sistemas
JAZ.MC = Jazztel
MAP.MC = Mapfre
REE.MC = Red Electrica
REP.MC = Repsol YPF
SCYR.MC = Sacyr Vallehermoso
SAN.MC = Santander
TRE.MC = Tecnicas Reunidas
TEF.MC = Telefónica
VIS.MC = Viscofan
AKSO.OL = Aker Solutions
DNB.OL = DnB NOR
DNO.OL = DNO Int.
FOE.OL = Fred.Olsen Energy
GJF.OL = Gjensidige
MHG.OL = Marine Harvest
NHY.OL = Norsk Hydro
ORK.OL = Orkla
PGS.OL = PGS
PRS.OL = Prosafe
RCL.OL = RC Cruises
REC.OL = REC
SCH.OL = Schibsted
SDRLAD.OL = SeaDrill
STL.OL = Statoil
STB.OL = Storebrand
SUBC.OL = Subsea 7
TEL.OL = Telenor
TGS.OL = TGS
YAR.OL = Yara Intl
ALPHA.AT = ALPHA
BELA.AT = Bela
EEE.AT = EEE
ELLAKTOR.AT = ELLAKTOR
ELPE.AT = ELPE
ETE.AT = ETE
EUPRO.AT = EUPRO
FFGRP.AT = FFGRP
HTO.AT = HTO
MOH.AT = MOH
MYTIL.AT = MYTIL
OPAP.AT = OPAP
PPA.AT = PPA
PPC.AT = PPC
SOLK.AT = SOLK
TITK.AT = TITK
TPEIR.AT = TPEIR
ACP:WSE = Asseco Poland
PEO:WSE = Bank Pekao
BZW:WSE = Bank Zachodni WBK
LWB:WSE = Bogdanka
BRE:WSE = mBank
BHW:WSE = Citi Handlowy
EUR:WSE = Eurocash
LTS:WSE = Grupa LOTOS
JSW:WSE = JSW
KER:WSE = Kernel Holding
KGH:WSE = KGHM Polska Miedź
PGE:WSE = PGE
PGN:WSE = PGNiG
PKN:WSE = PKN Orlen
PKO:WSE = PKO Bank Polski
PZU:WSE = PZU
SNS:WSE = Synthos
TPE:WSE = Tauron
TPS:WSE = Telekomunikacja Polska
BES.LS = BES
EDP.LS = EDP
EDPR.LS = EDP Renovaveis
GAL.LS = Galp Energia
JMT.LS = Jerónimo Martins
PTC.LS = Portugal Telecom
SON.LS = Sonae
ZONOP.LS = ZON Multimedia
CL = Oil
XAU = Gold
NG = Natural Gas
XAG = Silver
PA = Palladium
KC = Coffee
HG = Copper
ZC = Corn
CT = Cotton
SB = Sugar
HO = Heating Oil
PL = Platinum
ZS = Soybeans
CC = Cocoa
UK100 = UK 100
YM = USA 30
NQ = US-TECH 100
ES = USA 500
FDAX = Germany 30
FIBi = Italy 40
NIY = Japan 225
FESX = Europe 50
FTASE = Greece 20
F2MX = Germany MCap
FCE = France 40
HSI = Hong Kong 45
SPI200 = Australia 200
OMXS30 = Sweden 30
OBX = Norway 25
FSM = Swiss 20
WIG20 = Poland 20
FT = Netherlands 25
OMXC20CAP = Denmark 20
GBPUSD = GBP/USD
EURUSD = EUR/USD
GBPJPY = GBP/JPY
GBPCAD = GBP/CAD
GBPAUD = GBP/AUD
EURGBP = EUR/GBP
EURSEK = EUR/SEK
EURCAD = EUR/CAD
EURJPY = EUR/JPY
EURSGD = EUR/SGD
EURNZD = EUR/NZD
EURAUD = EUR/AUD
EURCHF = EUR/CHF
EURNOK = EUR/NOK
USDCAD = USD/CAD
USDCHF = USD/CHF
USDJPY = USD/JPY
USDNOK = USD/NOK
NZDUSD = NZD/USD
AUDUSD = AUD/USD
AUDNZD = AUD/NZD
GBPCHF = GBP/CHF
GBPNZD = GBP/NZD
GBPSEK = GBP/SEK
GBPDKK = GBP/DKK
GBPNOK = GBP/NOK
AUDJPY = AUD/JPY
AUDCHF = AUD/CHF
AUDCAD = AUD/CAD
AUDSGD = AUD/SGD
CHFDKK = CHF/DKK
CHFSEK = CHF/SEK
CHFJPY = CHF/JPY
CHFNOK = CHF/NOK
CADJPY = CAD/JPY
CADCHF = CAD/CHF
NZDCAD = NZD/CAD
NZDCHF = NZD/CHF
NZDJPY = NZD/JPY
DKKNOK = DKK/NOK
SEKNOK = SEK/NOK
LTCUSD = Litecoin Daily
BTCUSD = Bitcoin
USDSGD = USD/SGD
USDSEK = USD/SEK
EURMXN = EUR/MXN
USDDKK = USD/DKK
EURTRY = EUR/TRY
USDTRY = USD/TRY
USDCNH = USD/CNH
USDPLN = USD/PLN
USDHKD = USD/HKD
EURPLN = EUR/PLN
EURCZK = EUR/CZK
USDCZK = USD/CZK
USDHRK = USD/HRK
USDHUF = USD/HUF
USDLTL = USD/LTL
USDZAR = USD/ZAR
USDMXN = USD/MXN
USO = USO-Oil Fund
SLV = iShares Silver
UNG = UNG-Gas Fund
OIH = OIH-Oil Service
DBC = Commodity Index Fund
GOLD.AX = ETFS Gold
VXX = VXX Volatility
EXS1.DE = iShares DAX
SPY = SPY
DIA = DIA
EXW1.DE = iShares EU50
QQQ = QQQ
TZA = TZA
FXE = FXE
ACWI = ACWI
EEM = iShares EEM
TLT = TLT
LQD = LQD
IWM = iShares R2000
XLK = XLK
FXI = iShares China
STW.AX = SPDR ASX 200
TNA = TNA
ISF-L = iShares FTSE
GDX = GDX
RSX = RSX
CAC.PA = Lyxor CAC
IAEX.AS = iShares AEX
EWJ = iShares Japan
TWM = TWM
XOP = XOP
FAZ = FAZ
XME = XME
HYG = HYG
TBT = TBT
ERX = ERX
FEZ = SPDR EURO 50
EDC = EDC
EWZ = EWZ
XLF = XLF
QLD = QLD
FAS = FAS
VTI = VTI
JNK = JNK
XLI = XLI
SPXU = SPXU
AGQ = AGQ
BND = BND
DVY = DVY
XLP = XLP
SFY.AX = SPDR ASX 50
SDS = SDS
XLE = XLE
SH = SH
QID = QID
VNQ = VNQ
XLU = XLU
UPRO = UPRO
XLV = XLV
MDY = MDY
EWH = EWH
EWW = EWW
VGK = VGK
EFA = EFA
VWO = VWO
EWY = iShares Korea
IJR = IJR
XLB = XLB
SSO = SSO
IAU = IAU
XRT = XRT
IYR = IYR
XLY = XLY
IWO = IWO
SPXL = SPXL
IWF = IWF
XHB = XHB
EWT = EWT
IWN = IWN